###################
##             #  #
#  ##  ###   #    #
#    ###        ###
#  #   ########   #
# #   #X#@    ## K#
#   #   ###   #   #
#    ###        ###
#  ##  #     #    #
##     #      ##  #
###################