###################
####  X#   #     @#
###               #
#     #       #   #
###   #        #  #
#    ##         # #
#     #          ##
#     #           #
#   # #     #     #
#  #  ###      # K#
###################