###################
##                #
##      #        X#
#        #       ##
#    #   #        #
# #K  #     ##    #
#       # #       #
#   #    #    #   #
#      #   #      #
#@#               #
###################