###################
#      K#X       ##
# ##   #####     ##
# #     ##        #
#       ##        #
#       @#   ##   #
#       ##   ##   #
#                 #
###              ##
###       #      ##
###################