###################
#@  #      ##     #
##         K      #
###           # ###
##          #    ##
#                 #
#            #    #
#     ##       # ##
##  #     # #  #  #
#  #     #      #X#
###################