###################
#K              ###
###               #
#  #  #           #
#   ##            #
#      ###        #
#        #        #
#    ### #     #  #
#####    #  #  #  #
#@       #  #  # X#
###################