###################
#@  #   #   #     #
# #   #   #   # # #
#   #   #   # ### #
# #   ##  # ###   #
#   # ###K  #   # #
### # #   #   #   #
#       #   #   ###
# #   # # #   #   #
#   #   # #######X#
###################