###################
#@       #K       #
##                #
#              #  #
#                 #
## ##### ##       #
#X#  #           ##
#          #      #
#               # #
#  #          #   #
###################