###################
#@#####          ##
# ##### #  # ### ##
#     #    # ### ##
#####      # #    #
##     #    ## ## #
#    ##  ##  #  ###
#  ##K      ### ###
#    ## # ## #    #
###          #  #X#
###################