###################
#K  #             #
#          #      #
#         # X     #
###        ##    ##
#          #      #
#                 #
#                 #
#                 #
#@ #              #
###################