###################
#@   #            #
#          #      #
#      # #        #
##      #      #  #
#     # K         #
#       #         #
#      # #       ##
##              # #
#   ##     #     X#
###################