###################
#@  #X    #      ##
#   #            ##
#   #             #
##         #      #
#  #              #
#                 #
#             K   #
# #        #  #  ##
##               ##
###################