###################
##  #   ##       ##
#       #         #
#  #       #   #  #
#   # # K   # #   #
#@               X#
#   # #     # #   #
#  #   #       #  #
#         #       #
##       ##   #  ##
###################