###################
##  #  #      ## X#
#           # #  ##
##   # # #  # # # #
## #    #K  # #   #
#      #@# ##    ##
##  #       #     #
#       #        ##
#          #      #
#   # #      ## # #
###################