###################
#   #             #
#                 #
#       ###       #
#               # #
#        #        #
#        #        #
#        #     X  #
#  #    K         #
#    @            #
###################