###################
#     #        #X##
# K          #    #
#      #          #
#       #      #  #
#     #          ##
##          #     #
#                 #
#                 #
#    #  @       # #
###################