###################
#      #       #  #
##           #    #
#  #       #      #
#       #   #   # #
# K   #  @    #  ##
# #         ##    #
#        #    # ###
#  #   #     #    #
##    #      #  X #
###################