###################
##  #    K    #   #
#     ####### #   #
#      ##        ##
#  #   #          #
###      #### #   #
###         # ##  #
##      # # # #  ##
##        # # #####
#    #    #@#    X#
###################