###################
#      ##       ###
# #           # X##
#              ####
##  #            ##
##      K        ##
##            #  ##
####              #
##@ #           # #
###     ##        #
###################