###################
##      #       ###
#                ##
#        #        #
#         #       #
#      #@X#       #
#        #        #
##                #
#K      #        ##
#       ##     #  #
###################