###################
# # ##     #      #
#  K      #       #
# ###             #
# #             # #
#       X        ##
#      @  #       #
#               # #
#     #           #
#  #              #
###################