###################
#                 #
#                 #
#         #       #
#   #   #      X  #
#   @ #    #      #
# #      #    #   #
#    # #      K   #
#              #  #
#  #              #
###################