###################
#@#     ###    #  #
#   #             #
#       ####    ###
##  # # ###      ##
#                ##
#   # #     #   # #
#   #       #     #
# #             # #
#K##   ###    #  X#
###################