###################
##   #          ###
#          #     ##
#        #     # ##
#   #     #   #   #
##    #      #    #
#    K#     #  #  #
#      #   #  #  ##
#       #X#  #    #
#       #@  #     #
###################