###################
#     # #         #
# # #    X  ##    #
#  #            # #
#                 #
#  #  #@      #   #
#  #  #       #   #
#  #  ####  K#    #
#   ##            #
#            #    #
###################