###################
#         ##    # #
#      #  #       #
#  #     @#K      #
#    #   #        #
#        X       ##
#   #             #
#      #   #      #
#   #             #
#          #    # #
###################