###################
##   #   #       ##
# @#      #    #  #
# #X#         # # #
#       # #       #
##       K       ##
#       # #       #
# #             # #
#  #    #      #  #
##       #       ##
###################