###################
#        #    #  @#
#     #X          #
#            #    #
#   #             #
#           #     #
#                 #
#  K              #
#  #       #      #
#    #           ##
###################