###################
#  ##  #    #    X#
#        #        #
## # # #       #  #
#     #  # #  #   #
#  #    #    #    #
##    #           #
#    #   # #  # ###
# #  #  #         #
#@   #  #  # #  #K#
###################