###################
#        #   # # X#
# #     #      #  #
#     # #  #      #
#   #      #    # #
##      #K#      ##
# #    #      #   #
#      #  # #     #
#  #      #     # #
#@ # #   #        #
###################