###################
#@        #       #
#                 #
#     #           #
#               # #
#          K      #
#          #      #
#    #    #X      #
#        #     #  #
#                 #
###################