###################
# #   #           #
#             #   #
#  #              #
#       #@        #
#      K #     ####
#              #X #
#             #   #
##         #      #
#   #     #       #
###################