###################
###         #     #
##                #
#         #       #
#     # ##       ##
#  #             X#
#                ##
#        #       K#
#    #     #      #
#                @#
###################