###################
#        @#  #   ##
#  #   X#         #
##            #   #
#    # K          #
#                 #
# #            #  #
#     #      #    #
# #         #     #
#     #  #      # #
###################