###################
#         #      X#
#     #         # #
##       #   #    #
# #   #           #
#   #     #       #
#            # #  #
#  #   #          #
## #     # K #    #
#@     #          #
###################