###################
#                 #
#   #      #  #   #
#       #         #
#@#    #        # #
##    # K   #     #
#              #  #
#   #     #  # #  #
#   ##            #
#X    #          ##
###################