###################
#                 #
#      #          #
#               # #
##     X          #
#   #    @        #
#          K     ##
#  #              #
#          #      #
#       #         #
###################