###################
#  #     # #      #
#      #          #
# #  #    #K##    #
#         #    #  #
##   #  #@#  #   ##
#  #    #         #
#    ##X#    #  # #
#          #      #
#      # #     #  #
###################