###################
### # # ##      #X#
#K             ## #
### # # #       # #
#              ## #
# # # # #  #    # #
#             ### #
# # # # #       # #
#         #   # # #
#@# # # #     #   #
###################