###################
###################
####          X####
#### ##############
#### ##############
#### ##############
#### ##############
#### ##############
#### ##############
####@##############
###################