###################
#                 #
# ############### #
# #             # #
# # ########### # #
# # #K       X# # #
# # # ######### # #
# # #           # #
# # ############# #
#@#               #
###################