###################
#K ################
#               X##
## ################
## ################
## ################
## ################
## ################
##@################
###################
###################