###################
###################
###################
#####  #     ######
#####       KX#####
#####      # ######
#####@#  #   ######
###################
###################
###################
###################