###################
#  #         #    #
#        #      # #
#    #     #      #
#      ##         #
#        @     #  #
#   #   X K       #
# #           #   #
#    #   #  #     #
#     #          ##
###################