###################
#@ #           # K#
#    #   #   #    #
##        #      ##
#   #         ##  #
# #     # #     # #
#  ##         #   #
##      #        ##
#    #   #   #    #
#X #           #  #
###################