###################
#K#        #    # #
#                 #
#       #         #
#  #              #
#             #   #
#   #          #  #
##             # ##
##           # # X#
#@       #     ## #
###################