###################
#             # X #
#                 #
#                 #
#   ######        #
#   #   K#        #
#   #             #
#   #    #     #  #
#   # ####        #
#@  #             #
###################