###################
#X #K             #
#                 #
#      #          #
#          #      #
#        @        #
#     #           #
#        #      # #
#          #      #
# #               #
###################