###################
#                 #
#              #  #
#  #              #
#         #       #
#               # #
# #               #
#                ##
#        #        #
#@  X      #     K#
###################