###################
#       @     #   #
#K                #
#    #    #       #
##    # #         #
#   #             #
#  #        #     #
#    #            #
# #               #
#    #    #    # X#
###################