###################
#@ # # #  #     # #
#    # #        # #
#      #          #
#      K#    ######
#     #      #   X#
#     ## #  ###   #
#   # ##        ###
# # # ###   ##    #
# # # #   ##     ##
###################