###################
####              #
###  # # # #      #
##  ###############
## #  #  #  #     #
#X              #K#
## #  #   #   #   #
##  ##########  ###
###     #     # @##
####           ####
###################