###################
#@#X             ##
# ############## ##
# ###      #     ##
# ##    ###    # ##
#    #       ### ##
# # ###########  ##
# # ##  ###   #  ##
#   #    ## #   ###
##### K#    #######
###################